XXXX.XXXX
X.......X
X.......X
X.......X
.........
X.......X
X.......X
X.......X
XXXX.XXXX